108,26
000000000000000000000000000000000000000000000000000000000000000000000000000000000000000000000000000000000000
00__00000000000000000000000000000000000000000000000000000000000000000000000000000000000000000000000000000000
000000000000000000000000000000000000000000000000000000000000000000000000000000000000000000000000000000000000
000000000000000000000000000000000000000000000000000000000000000000000000000000000000000000000000000000000000
0000000000000000000000000000000000000000000000000000000000()000000()0000000000000000000000000000000000000000
000000000000000000000000000000000000000000000000000000()000000()00000000000000000000000000000000000000000000
9000000000000000000000000()00000000000000000000()00000000000000000000000000000000000000000000000000000000000
60000000000000000008229000000000g000(_)000000000000()0000000000000000822222290000000000000000000000000000000
60000000000000()0007AA6000000(___)0000000082229000000000000000000()007AAAAAA60000000000000000000000000000000
600000000(_)00000007AA429000000000000000007AAA60000000000000(_)0000007AAAAAA60000000000000000000000000000000
6000000000000(___)07AAAA6g00000000000000825AAA600000000000000000000()7AAAAAA60000000000000000000000000000082
600(__)0000000000007AAAA42290000000(__)07AAAAA600000000000000000000007AAAAAA6000000000000000000000000000007A
6000000s000g00000g07AAAAAAA600000g0000007AAAAA60000000000000000(_)0007AAAAAA6000000000000000000000000000007A
42222222222222222225AAAAAAA6000(__)000007AAAAA60000000000(__)000000007AAAAAA600000000000000(__)00000(__)007A
AAAAAAAAAAAAAAAAAAAAAAAAAAA60000000000007AAAAA6000000(_)00000000000007AAAAAA4222222229000000000000000000007A
AAAAAAAAAAAAAAAAAAAAAAAAAAA42222222222225AAAAA600000000000000822222225AAAAAAAAAAAAAAA6000000000000000000007A
AAAAAAAAAAAAAAAAAAAAAAAAAAAAAAAAAAAAAAAAAAAAAA6000000000000007AAAAAAAAAAAAAAAAAAAAAAA60000000000(__)0000007A
AAAAAAAAAAAAAAAAAAAAAAAAAAAAAAAAAAAAAAAAAAAAAA60000000000(_)07AAAAAAAAAAAAAAAAAAAAAAA6000000000000000000007A
AAAAAAAAAAAAAAAAAAAAAAAAAAAAAAAAAAAAAAAAAAAAAA6000(_)000000007AAAAAAAAAAAAAAAAAAAAAAA6000(__)00000000082225A
AAAAAAAAAAAAAAAAAAAAAAAAAAAAAAAAAAAAAAAAAAAAAA42900000(_)00007AAAAAAAAAAAAAAAAAAAAAAA600000000000000007AAAAA
AAAAAAAAAAAAAAAAAAAAAAAAAAAAAAAAAAAAAAAAAAAAAAAA60000000000007AAAAAAAAAAAAAAAAAAAAAAA600000000000000007AAAAA
AAAAAAAAAAAAAAAAAAAAAAAAAAAAAAAAAAAAAAAAAAAAAAAA42222222222225AAAAAAAAAAAAAAAAAAAAAAA422222222222222225AAAAA
AAAAAAAAAAAAAAAAAAAAAAAAAAAAAAAAAAAAAAAAAAAAAAAAAAAAAAAAAAAAAAAAAAAAAAAAAAAAAAAAAAAAAAAAAAAAAAAAAAAAAAAAAAAA
AAAAAAAAAAAAAAAAAAAAAAAAAAAAAAAAAAAAAAAAAAAAAAAAAAAAAAAAAAAAAAAAAAAAAAAAAAAAAAAAAAAAAAAAAAAAAAAAAAAAAAAAAAAA
AAAAAAAAAAAAAAAAAAAAAAAAAAAAAAAAAAAAAAAAAAAAAAAAAAAAAAAAAAAAAAAAAAAAAAAAAAAAAAAAAAAAAAAAAAAAAAAAAAAAAAAAAAAA
AAAAAAAAAAAAAAAAAAAAAAAAAAAAAAAAAAAAAAAAAAAAAAAAAAAAAAAAAAAAAAAAAAAAAAAAAAAAAAAAAAAAAAAAAAAAAAAAAAAAAAAAAAAA
