48,8
000000000000000000000000000000000000000000000000
000000000000000000000000000000000000000000000000
000s0000000000000000000000<_>00000000<_>00000000
<_______>0000<_______>0000000000000000000<_>0000
0000000000000000000000000000<_>0000000<____>0000
000000000000000<_>00000000000000<____>0000000000
000000000000000000000000000000000000000000000000
00000<____>0000000<____>000000000000000000000000







